7
10
XXXXXXXXXX
XS       X
XXXXXXX  X
XE    X  X
XXXXX X  X
X        X
XXXXXXXXXX